TituloVentana = Maracars gestor de vehiculo
TituloDialogo= Nuevo Circuito
DescripcionCambioDeIdioma = Cambiar al idioma seleccionado
Nombre = Nombre
Valor = Valor
Controlador = Panel de Control
TablaDatos = Tabla de Datos
Configuracion = Configuracion
Idiomas = Idiomas
DescripcionCambioDeModo = Cambiar al modo seleccionado
Automatico = Automático
Modos = Modos
Manual = Manual
Mapa = Panel del Mapa
BordeGiro= Giro
BordeAceleracion=Aceleración
BordeConexion=Estado de la conexión
Conectado=Conectado
Desconectado=Desconectado
LongitudCoche= Longitud del coche
AnchoCoche=Ancho del coche
AnchoPista=Ancho de la pista
LongitudRecta=Longitud de la pista
RadioAncho= Radio más ancho
CoeficienteFriccion= Coeficiente de friccion
Reloj=En sentido de las agujas
Contrareloj=En contra del sentido de las agujas
AñadirPista=Añadir un nuevo circuito
Empezar=Empezar
Parar=Parar
NuevoConjunto= Nuevo circuito
SimulacionSi=Simulación iniciada
SimulacionNo=Simulación no iniciada
Nombres=Nombres
Valores=Valores
Obstaculo=Obstaculo
Giro=Giro
Distancia=Distancia
Motor=Motor
Velocidad=Velocidad