TituloVentana = Maracars vehicle manager
TituloDialogo=New circuit
DescripcionCambioDeIdioma = Change to the selected language
Nombre = Name
Valor = Value
Controlador = Control Panel
TablaDatos = Data Table
Configuracion = Configuration
Idiomas = Languages
DescripcionCambioDeModo = Change to the selected mode
Automatico = Automatic
Modos = Modes
Manual = Manual
Mapa = Map Panel
BordeGiro= Turn
BordeAceleracion=Acceleration
BordeConexion=Connection status
Conectado=Connected
Desconectado=Disconnected
LongitudCoche= Car's length
AnchoCoche=Car's width
AnchoPista=Path's width
LongitudRecta=Straight path's length
RadioAncho= Widest radius
CoeficienteFriccion=Coefficient of friction
Reloj=Clockwise
Contrareloj=Counterclockwise
AñadirPista=Add a new circuit 
Empezar=Start
Parar=Stop
NuevoConjunto=New circuit
SimulacionSi=Simulation started
SimulacionNo=Simulation not started
Nombres= Names
Valores=Values
Velocidad=Speed
Obstaculo=Obstacle
Giro=Turn
Distancia= Distance
Motor=Motor
NoValido=These values are not valid
NoFormato=Format of the data not valid
NoRellenado=Please fill all the blanks