TituloVentana = Maracars ibilgailu gestorea
TituloDialogo= Zirkuito berria
DescripcionCambioDeIdioma = Aldatu aukeratutako hizkuntzara
Nombre = Izena
Valor = Balioa
Controlador = Kontrol Panela
TablaDatos = Datuen Taula
Configuracion = Konfigurazioa
Idiomas = Hizkuntzak
DescripcionCambioDeModo = Aldatu aukeratutako modura
Automatico = Automatikoa
Modos = Moduak
Manual = Manuala
Mapa = Maparen Panela
BordeGiro= Bira
BordeAceleracion=Azelerazioa
BordeConexion=Konexioaren egoera
Conectado=Konektatuta
Desconectado=Deskonektatuta
LongitudCoche=Kotxearen luzeera
AnchoCoche=Kotxearen zabalera
AnchoPista=Pistaren zabalera
LongitudRecta=Pistaren luzeera
RadioAncho=Erradio zabalena
CoeficienteFriccion= Marruskadura koefizientea
Reloj=Erlojuaren orratzen norantzan
Contrareloj=Erlojuaren orratzen aurkako norantzan
AñadirPista=Zirkuito berri bat gehitu
CircunferenciaRueda=Gurpilaren zirkunferentzia
Empezar=Hasi
Parar=Gelditu
NuevoConjunto=Zirkuitu berria
SimulacionSi=Simulazioa hasita
SimulacionNo=Simulazioa hasi gabe
Nombres=Izenak
Valores=Baloreak
Velocidad=Abiadura
Obstaculo=Oztopoa
Giro= Bira
Distancia=Distantzia
Motor=Motorra
NoValido= Balore hauek ez dira egokiak
NoFormato=Datuen formatua ez da egokia
NoRellenado=Mesedez, bete hutsune guztiak